5
10
.*.....OO.
.O.....**O
..*...*.SO
..........
OO..OOO*.O
