5
10
......*...
.....*....
.*O....O.*
OOO...*OOO
.S.......*
