5
10
.....SOO..
**...*.*..
........O.
O*..*..OOO
*.....OOO.
