5
11
....*.*OO..
...........
**O........
.*OSO...O..
....*O.OO..
