10
10
*.........
.*........
..*.......
...*......
....*.....
.....*....
......*...
..S....*..
........*.
.........*
