5
12
OO.*......*.
.O....*.O..O
*...O..O*..*
O.O.*.......
O......OO.S*
