5
14
.......*...*..
....O.....*..O
..O.....OO...*
.S......*.....
O.O*.O*.OO....
