5
11
......*..*.
.*O..OO*...
.S*....O...
.*OOO...O.*
.......*.O.
