5
10
...O.....O
..O...OO.O
.O*...S*..
*....*..*.
.O......OO
