5
10
*.........
...OOO....
.S....*...
OOOOOO....
*.........
