5
12
*O.*..O.O...
......S*..O.
.....*.O...O
..........O.
..O*..*.O...
