5
10
.....*....
OO..*..*..
.*..OS...*
..*....*..
.....*....
