5
12
...*......OO
*...O....**.
O.........O.
..*....*O.O.
.....**S.O..
