6
10
..........
..........
.S.OO..*..
....OOO...
....*.OOOO
..........
